###########################################################
#                                                         #
#                                                         #
#                                                         #
#                                                         #
#                                                         #
#                                                         #
#                                                         #
#                                                         #
#                                                         #
#                                                         #
#                                                         #
#                                                         #
#                                                         #
#                                                         #
#                                                         #
#                                                         #
#                                                         #
#                                                         #
#                                                         #
#          P                                              #
###########################################################